1111111111
1000000001
1000000001
1000000001
1CCCCCCCC1
1PE0000001
1000000001
1000000001
1000000001
1111111111