11111
100P1
100F1
1CCC1
1E001
11111