1111111111
1P00000001
1000C00001
1000000C01
100000C001
1000E00001
1111111111