1111111111111111111111111111
1C000000000001100000000000C1
1011110111110110111110111101
101111C11111011011111C111101
1011110111110110111110111101
1000000000000000000000000001
1011110110111111110110111101
1011110110111111110110111101
1000000110000110000110000001
1000000110000110000110000001
1011110110000000000110111101
1011110110111001110110111101
100000011010F000010110000001
10000001101E0000P10110000001
1011110110111111110110111101
1011110110000000000110111101
1000000110000110000110000001
1000000110000110000110000001
1011110110111111110110111101
1011110110111111110110111101
1000000000000000000000000001
1011110111110110111110111101
101111C11111011011111C111101
1011110111110110111110111101
1C000000000001100000000000C1
1111111111111111111111111111